5 10
|--------|
|.G.|..-.|
|..-|.@.P|
|.G....-.|
|--------|